8,8,8,8,8,8,8,8,8,8,8,8,8,8,8,8,8,8,8,8,8,8,8,8,
8,8,8,8,8,8,8,8,8,8,8,8,8,8,8,8,8,8,8,8,8,8,8,8,
8,8,8,8,0,0,8,8,8,8,8,8,8,8,8,8,8,8,8,8,8,8,8,8,
8,8,8,8,0,3,8,8,1,8,8,8,8,8,8,8,8,8,8,8,8,8,8,8,
8,8,8,8,0,0,0,0,0,0,0,0,0,0,8,8,8,8,8,8,8,8,8,8,
8,8,8,8,0,0,0,0,0,0,0,0,0,3,8,1,8,8,8,8,8,8,8,8,
8,8,8,8,0,0,0,0,0,0,0,0,0,0,0,0,0,0,0,0,4,4,4,4,
8,8,8,8,0,0,0,0,0,0,0,0,0,0,0,0,0,0,0,0,4,4,4,4,
0,0,0,0,0,0,0,0,0,0,3,0,0,0,0,0,0,0,0,0,4,4,4,4,
0,0,0,0,0,0,0,0,0,0,0,0,0,0,0,0,0,0,0,0,4,4,4,4,
8,8,8,8,8,8,8,8,0,0,0,0,0,0,0,0,0,0,0,8,8,8,8,8,
8,8,8,8,8,1,8,8,0,0,0,0,0,0,0,0,0,0,0,8,8,8,8,8,
8,8,0,0,0,0,0,0,0,0,0,0,8,8,8,8,0,0,0,8,8,8,8,8,
8,8,0,0,0,0,0,0,0,0,0,3,8,1,8,8,0,0,0,8,8,8,8,8,
8,8,8,8,0,0,0,0,0,0,0,0,0,0,0,0,0,0,0,8,8,8,8,8,
8,8,8,8,8,8,8,8,0,0,0,0,0,0,0,0,0,0,0,8,8,8,8,8,
8,8,8,8,8,8,8,8,8,8,8,8,8,8,8,8,8,8,8,8,8,8,8,8,
8,8,8,8,8,8,8,8,8,8,8,8,8,8,8,8,8,8,8,8,8,8,8,8,
